{
  "↑": "大",
  "W": "大",
  "大": "大",
  "↓": "下",
  "S": "下",
  "防": "下",
  "a": "普",
  "A": "普",
  "O": "O",
  "M": "O"
}
